description,completed,value,new_balance
Resaurant/Takeway,2016-12-31T20:37:42Z,-171.76HKD,6823.85HKD
Transfer,2016-12-31T11:32:54Z,-3119.09HKD,6995.61HKD
Bar,2016-12-31T10:43:23Z,-274.37HKD,10114.70HKD
Bar,2016-12-31T06:05:21Z,-280.00HKD,10389.07HKD
Dentist,2016-12-30T15:46:28Z,-538.61HKD,10669.07HKD
Parmacy,2016-12-30T12:18:17Z,-73.94HKD,11207.68HKD
Restaurant/Takeway,2016-12-30T09:24:33Z,-46.10HKD,11281.62HKD
Shopping,2016-12-30T00:42:30Z,-290.12HKD,11327.72HKD
coffee,2016-12-29T13:45:21Z,-52.88HKD,11617.84HKD
Yatch Club,2016-12-29T13:17:36Z,-556.36HKD,11670.72HKD
Takeway,2016-12-29T12:43:20Z,-777.47HKD,12227.08HKD
Restaurant,2016-12-29T12:18:15Z,-371.73HKD,13004.55HKD
Restaurant,2016-12-29T05:40:41Z,-498.60HKD,13376.28HKD
Yatch Club,2016-12-29T01:06:26Z,-538.49HKD,13874.88HKD
Bar,2016-12-28T14:02:26Z,-748.39HKD,14413.37HKD
coffee,2016-12-28T13:24:23Z,-69.75HKD,15161.76HKD
Takeway,2016-12-28T10:30:10Z,-451.76HKD,15231.51HKD
coffee,2016-12-28T09:13:51Z,-69.75HKD,15683.27HKD
Restaurant,2016-12-24T22:37:27Z,-65.76HKD,15753.02HKD
Restaurant,2016-12-24T16:45:37Z,-138.56HKD,15818.78HKD
Shopping,2016-12-24T11:35:56Z,-930.02HKD,15957.34HKD
Shopping,2016-12-24T09:55:14Z,-577.69HKD,16887.36HKD
Bar,2016-12-24T02:31:49Z,-253.09HKD,17465.05HKD
coffee,2016-12-24T02:06:59Z,-43.81HKD,17718.14HKD
Shopping,2016-12-21T13:46:42Z,-716.04HKD,17761.95HKD
Shopping,2016-12-20T21:28:07Z,-331.96HKD,18477.99HKD
Shopping,2016-12-19T21:49:03Z,-716.04HKD,18809.95HKD
Shopping,2016-12-19T21:32:54Z,-722.14HKD,19525.99HKD
coffee,2016-12-18T19:25:14Z,-56.57HKD,20248.13HKD
Restaurant,2016-12-16T18:23:28Z,-295.05HKD,20304.70HKD
Filling Station,2016-12-13T03:49:30Z,-722.14HKD,20599.75HKD
Resaurant/Takeway,2016-12-13T02:36:04Z,-52.88HKD,21321.89HKD
Restaurtant/Takeway,2016-12-12T07:24:49Z,-108.45HKD,21374.77HKD
Bar,2016-12-12T06:53:16Z,-457.22HKD,21483.22HKD
Monthly Sky,2016-12-04T15:07:55Z,-967.82HKD,21940.44HKD
Shopping,2016-12-04T06:07:18Z,-1692.24HKD,22908.26HKD
Salary Ref ID34215,2016-12-01T22:15:55Z,17670.90HKD,24600.50HKD
Gas/Elec,2016-12-01T22:11:17Z,-534.57HKD,6929.60HKD
Insurance Ref IDE5467,2016-12-01T18:50:28Z,-271.49HKD,7464.17HKD
Mortgage Ref DDE23461,2016-12-01T18:03:04Z,-6311.21HKD,7735.66HKD
Tax Ref 4583245,2016-12-01T16:19:02Z,-1371.30HKD,14046.87HKD
Water,2016-12-01T04:15:54Z,-323.24HKD,15418.17HKD
Bar,2016-11-27T18:52:01Z,-176.08HKD,15741.41HKD
Bar,2016-11-27T01:05:04Z,-262.70HKD,15917.49HKD
Restaurant,2016-11-21T13:54:19Z,-330.98HKD,16180.19HKD
Shopping,2016-11-21T05:07:44Z,-539.90HKD,16511.17HKD
Yatch Club,2016-11-20T05:05:52Z,325.84HKD,17051.07HKD
Restaurant/Takeway,2016-11-18T08:03:59Z,-73.43HKD,16725.23HKD
coffee,2016-11-16T20:16:35Z,-65.50HKD,16798.66HKD
Takeway,2016-11-14T16:45:17Z,-489.97HKD,16864.16HKD
Shopping,2016-11-14T15:30:28Z,-422.59HKD,17354.13HKD
Bar,2016-11-12T14:32:16Z,-399.10HKD,17776.72HKD
restaurant,2016-11-12T14:11:15Z,-231.28HKD,18175.82HKD
Filling Station,2016-11-09T15:37:15Z,-587.59HKD,18407.10HKD
coffee,2016-11-09T09:33:33Z,-45.12HKD,18994.69HKD
Cinema,2016-11-07T16:12:54Z,-245.00HKD,19039.81HKD
Restaurant,2016-11-07T11:38:35Z,-244.91HKD,19284.81HKD
resturant,2016-11-07T08:30:26Z,-343.31HKD,19529.72HKD
Restaurant/Takeway,2016-11-06T00:04:09Z,-156.38HKD,19873.03HKD
Water,2016-11-02T19:24:49Z,-323.24HKD,20029.41HKD
Gas/Elec,2016-11-02T18:17:18Z,-534.57HKD,20352.65HKD
Monthly Sky,2016-11-02T11:58:00Z,-967.82HKD,20887.22HKD
Mortgage Ref DDE23461,2016-11-02T06:26:41Z,-6311.21HKD,21855.04HKD
coffee,2016-11-02T04:31:56Z,-128.64HKD,28166.25HKD
Salary Ref ID34215,2016-11-02T03:32:36Z,17670.90HKD,28294.89HKD
Insurance Ref IDE5467,2016-11-02T01:25:37Z,-271.49HKD,10623.99HKD
Tax Ref 4583245,2016-11-02T00:49:00Z,-1371.30HKD,10895.48HKD
coffee,2016-10-26T19:07:17Z,-49.75HKD,12266.78HKD
Filling Station,2016-10-26T18:40:51Z,-717.48HKD,12316.53HKD
Shopping,2016-10-25T03:03:12Z,-427.33HKD,13034.01HKD
Restaurant,2016-10-18T08:40:33Z,-210.61HKD,13461.34HKD
Takeway,2016-10-17T21:34:16Z,-134.55HKD,13671.95HKD
Bar,2016-10-10T04:33:36Z,-403.66HKD,13806.50HKD
Cash Withdrawal,2016-10-09T08:37:53Z,-3119.09HKD,14210.16HKD
Restaurant/Takeway,2016-10-09T05:57:27Z,-49.75HKD,17329.25HKD
Bar,2016-10-09T03:28:51Z,-285.17HKD,17379.00HKD
coffee,2016-10-08T23:26:40Z,-97.49HKD,17664.17HKD
Restaurant,2016-10-07T19:43:00Z,-312.52HKD,17761.66HKD
Shopping,2016-10-07T14:25:45Z,-171.68HKD,18074.18HKD
Yatch Club,2016-10-05T10:04:02Z,-427.22HKD,18245.86HKD
coffee,2016-10-05T09:37:17Z,-52.96HKD,18673.08HKD
Filling Station,2016-10-04T02:07:16Z,-587.59HKD,18726.04HKD
Payment of Cerdit Card,2016-10-03T12:53:23Z,-528.03HKD,19313.63HKD
Payment of Cerdit Card,2016-10-03T10:55:31Z,-5312.83HKD,19841.66HKD
Payment of Cerdit Card,2016-10-03T08:40:53Z,-3119.09HKD,25154.49HKD
Restaurant/Takeway,2016-10-03T06:05:55Z,-295.05HKD,28273.58HKD
Payment of Cerdit Card,2016-10-03T02:50:19Z,-1506.59HKD,28568.63HKD
Monthly Sky,2016-10-02T05:54:26Z,-967.82HKD,30075.22HKD
Bar,2016-10-02T02:23:32Z,-644.85HKD,31043.04HKD
Water,2016-10-01T16:33:24Z,-323.24HKD,31687.89HKD
Mortgage Ref DDE23461,2016-10-01T14:10:24Z,-6311.21HKD,32011.13HKD
Tax Ref 4583245,2016-10-01T09:37:38Z,-1371.30HKD,38322.34HKD
Gas/Elec,2016-10-01T08:37:30Z,-534.57HKD,39693.64HKD
Bar,2016-09-29T00:59:16Z,-280.00HKD,40228.21HKD
Transfer,2016-09-27T17:21:22Z,-3119.09HKD,40508.21HKD
Resaurant/Takeway,2016-09-25T22:19:06Z,-171.76HKD,43627.30HKD
Bar,2016-09-25T21:23:10Z,-274.37HKD,43799.06HKD
Shopping,2016-09-24T17:28:46Z,-290.12HKD,44073.43HKD
Parmacy,2016-09-23T13:04:04Z,-73.94HKD,44363.55HKD
Dentist,2016-09-23T01:21:01Z,-538.61HKD,44437.49HKD
